GGGGGGGGGGGGGGGGGGGG
GGGGGGGGGGGGGGGGGGGG
GGGGGGGGGGGGGGGGGGGG
GGGGGGGGGGGGGGGGGGGG
XXXXXXXXAAMMMMMMMMMM
XXXXXXXAAAAMMMMMMMMM
XXXXXXXAAAAAMMMMMMMM
XXXXXAAAAAAAMMMMMMMM
XXXXXAAAAAAMMMMMMMMM
XXXXXXAAAAAMMMMMMMMM
XXXXXXXAAAAAMMMMMMMM
GGGGGGGGGGGGGGGGGGGG
GGGGGGGGGGGGGGGGGGGG
GGGGGGGGGGGGGGGGGGGG
GGGGGGGGGGGGGGGGGGGG
