00000000000000000000
00000000000000000000
00000000000000000000
00000000GGGGGG000000
0000000GGG00GGGGGG00
000000GG0GGGG0G00000
000000GG00G000G00000
0000000GG0GG0GG00000
00000000000GGG000000
00000000000000000000
00000000000000000000
00000000000000000000
00000000000000000000
00000000000000000000
00000000000000000000
